{
    "0": "11111111111111111111111111111111",
    "1": "11111111111111111111111111111111",
    "2": "11111111100000000001111111111111",
    "3": "11111000000000000000011111111111",
    "4": "11100000000000000000001111111111",
    "5": "11000000000000000000001111111111",
    "6": "11000000000000000000000111111111",
    "7": "11000000000000000000000111111111",
    "8": "10000000000000000000000111111111",
    "9": "10000000000000000000000111111111",
    "10": "12222000002222222200000111111111",
    "11": "11111000000111111100000111111111",
    "12": "11110000000001111100000111111111",
    "13": "11100000000000111100000111111111",
    "14": "11000222000000001100000111111111",
    "15": "11000000000000000100000111111111",
    "16": "11000000000000000100000111111111",
    "17": "11000000022200000100002111111111",
    "18": "10000000000000000100000111111111",
    "19": "10000000000000000100000111111111",
    "20": "10022200000000000100000111111111",
    "21": "10000000000000000100000011111111",
    "22": "12000000000000002100000011111111",
    "23": "11222222222222221100000011111111",
    "24": "11111111111111111120000011111111",
    "25": "11111111111111111100000001111111",
    "26": "11111111111111111000000000111111",
    "27": "11111111111100000000000000000111",
    "28": "11110000000000000000000000000001",
    "29": "11000000000000000000000000000000",
    "30": "00000000000000000000000000000000",
    "31": "00000000000000000000000000000000",
    "32": "00000000000000000000000000000000",
    "33": "00000000000000000000000000000000",
    "34": "00000000000000000000000000000000",
    "35": "00000000000000000000000000000000",
    "36": "00000000000000000000000000000000",
    "37": "00000000000000000000000000000000",
    "38": "02000000000000000000000000000002",
    "39": "01220000000000000000000000000221",
    "40": "01112200000000000000000000222111",
    "41": "01111122222200000000002222111111",
    "42": "01111111111122222222221111111111",
    "43": "00111111111111111111111111111110",
    "44": "00001111111111111111111111111000",
    "45": "00000011111111111111111111110000",
    "46": "00000000111111111111111111000000",
    "47": "00000000000000000000000000000000",
    "48": "00000000000000000000000000000000",
    "49": "20000000000000000000000000000020",
    "50": "12200000000000000000000000002210",
    "51": "11122200000000000000000000221110",
    "52": "11111122220000000000222222111110",
    "53": "11111111112222222222111111111110",
    "54": "11111111111111111111111111111100",
    "55": "11111111111111111111111111110000",
    "56": "11111111111111111111111111000000",
    "57": "11111111111111111111111100000000",
    "58": "11111100000000000000000000000000",
    "59": "11110000000000000000000000000000",
    "60": "11100000000000000000000000000000",
    "61": "11000000000000000000000000000000",
    "62": "11222222222222222222222222222222",
    "63": "11111111111111111111111111111111"
}