000000000000000000000000000000
000000000000000000000000000000
000000000000000000000000000000
000000000000000000000000000000
000000000000000000000000000000
000000000000000000000000000000
000000000000000000000000000000
000022220000000000000000200000
000001110000022000000002100000
000000000000011000000001100000
000000000000000000000000000000
000000000000000000000000000000
000222222220000022222000000000
002111111112000211111000000000
001111111111000011111000000000
001111111111000001110000000000
000111111110000000000000000000
000000000000000000000000022200
000000000000000000000000211100
000000000000000000000000000000
