11111111111111111111111111111111
11111111111111111111111111111111
11111111100000000001111111111111
11111000000000000000011111111111
11100000000000000000001111111111
1100000000000S000000001111111111
11000000000000000000000111111111
11000000000000000000000111111111
10000000000000000000000111111111
10000000000000000000000111111111
12222000002222222200000111111111
11111000000111111100000111111111
11110000000001111100000111111111
11100000000000111100000111111111
11000222000000001100000111111111
11000000000000000100000111111111
11000000000000000100000111111111
11000000022200000100002111111111
10000000000000000100000111111111
10000000000000000100000111111111
10022200000000000100000111111111
10000000000000000100000011111111
12000000000000002100000011111111
11222222222222221100000011111111
11111111111111111120000011111111
11111111111111111100000001111111
11111111111111111100000000111111
11111111111111111120000000111111
11110000000111111112000000111111
11000000000000000111220000111111
10000000000000000000000000111111
10000000000000000000000000111111
10000000000000000000000000111111
10000000000000000000000000111111
10000000000000000000000000111111
10000000000000000000000000111111
10000000000000000000000000111111
10000000000000000000000000111111
10000000000000000000000000111111
10220000000000000000000000111111
10112200000000000000000000111111
10111122222200000000002222111111
10111111111122222222221111111111
10011111111111111111111111111111
10001111111111111111111111111001
10000011111111111111111111110001
10000000111111111111111111000001
10000000000000000000000000000001
10000000000000000000000000000001
10000000000000000000000000000001
12200000000000000000000000002201
11122200000000000000000000221101
11111122220000000000222222111101
11111111112222222222111111111101
11111111111111111111111111111101
11111111111111111111111111110001
11111111111111111111111111000001
11111111111111111111111100000001
11111100000000000000000000000001
11110000000000000000000000000001
11100000000000000000000000000001
11000000000000000000000000000001
11222222222222222222222222222221
11111111111111111111111111111111
